1111111111111111111111111
1P0CCCCCCCCCCCCCCCCCCCCC1
1CCC1CC111CC111CC11111CC1
1CC11CCCC1CCCC1CCCCC11CC1
1C101CCCC1CCCC1CCCCC11CC1
1CCC1CCCC1CCCC1CCCC11CCC1
1CCC1CC111CC111CCCC11CCC1
1CCC1CCCC1CCCC1CCC11CCCC1
1CCC1CCCC1CCCC1CCC11CCCC1
1CCC1CCCC1CCCC1CC11CCCCC1
1CC111C111CC111CC11CCCCC1
1CCCCCCCCCCCCCCCCCCCCCCE1
1111111111111111111111111