111111111111
1CCCCCCCCCC1
1CC1C1C11CC1
1CC1C1C01CC1
1CC111P11CC1
1CCCC1C1ECC1
1CCCC1C11CC1
1CCCCCCCCCC1
1CCCCCCCCCC1
111111111111