11111111111111111111111111
10000000000011000000000001
10111101111011011110111101
10111101111011011110111101
10111101111011011110111101
10000000000000000000000001
10111101011111111010111101
10000001000011000010000001
11111101111011011110111111
11111101000000000010111111
11111101011100111010111111
10000000010000001000000001
1111110101110011101N111111
100000000C0000000000000001
100000000000CP000000000001
100000000E0000000000000001
11111111111111111111111111