11111111111111111111111111
10000000000011000000000001
10111101111011011110111101
10111101111011011110111101
10111101111011011110111101
1000000CCC0000000000000001
1011110101111111101N111101
10000001000011000010000001
11111101111011011110111111
11111101000000000010111111
1111110101110011101C111111
1C00000001000000100C0000C1
1111110101110011101C111111
100000000C0000000000000001
10000000N0N0CP000000000001
10000000NEN000000000000001
11111111111111111111111111