11111111111111111111111111
10000000000011000000000001
10111101111011011110111101
10111101111011011110111101
10111101111011011110111101
10000000000000000000000001
10111101011111111010111101
10000001000011000010000001
11111101111011011110111111
111111010000C0000010111101
11111101011100111010111111
10000000010000001000000001
11111101011100111010111111
1000000000000E000000000001
1000000000000P000000000001
10000000CCC000000000000001
11111111111111111111111111